AatII	GACGTC	GACGTC
Acc65I	GGTACC	GGTACC
AccI	GTMKAC	GT[AC][GT]AC
AclI	AACGTT	AACGTT
AfeI	AGCGCT	AGCGCT
AflII	CTTAAG	CTTAAG
AgeI	ACCGGT	ACCGGT
ApaI	GGGCCC	GGGCCC
ApaLI	GTGCAC	GTGCAC
ApoI	RAATTY	[AG]AATT[CT]
AscI	GGCGCGCC	GGCGCGCC
AseI	ATTAAT	ATTAAT
AsiSI	GCGATCGC	GCGATCGC
AvrII	CCTAGG	CCTAGG
BamHI	GGATCC	GGATCC
BclI	TGATCA	TGATCA
BglII	AGATCT	AGATCT
Bme1580I	GKGCMC	G[GT]GC[AC]C
BmtI	GCTAGC	GCTAGC
BsaHI	GRCGYC	G[AG]CG[CT]C
BsiEI	CGRYCG	CG[AG][CT]CG
BsiWI	CGTACG	CGTACG
BspEI	TCCGGA	TCCGGA
BspHI	TCATGA	TCATGA
BsrGI	TGTACA	TGTACA
BssHII	GCGCGC	GCGCGC
BstBI	TTCGAA	TTCGAA
BstZ17I	GTATAC	GTATAC
BtgI	CCRYGG	CC[AG][CT]GG
ClaI	ATCGAT	ATCGAT
DraI	TTTAAA	TTTAAA
EaeI	YGGCCR	[CT]GGCC[AG]
EagI	CGGCCG	CGGCCG
EcoRI	GAATTC	GAATTC
EcoRV	GATATC	GATATC
FseI	GGCCGGCC	GGCCGGCC
FspI	TGCGCA	TGCGCA
HaeII	RGCGCY	[AG]GCGC[CT]
HincII	GTYRAC	GT[CT][AG]AC
HindIII	AAGCTT	AAGCTT
HpaI	GTTAAC	GTTAAC
KasI	GGCGCC	GGCGCC
KpnI	GGTACC	GGTACC
MfeI	CAATTG	CAATTG
MluI	ACGCGT	ACGCGT
MscI	TGGCCA	TGGCCA
MspA1I	CMGCKG	C[AC]GC[GT]G
NaeI	GCCGGC	GCCGGC
NarI	GGCGCC	GGCGCC
NcoI	CCATGG	CCATGG
NdeI	CATATG	CATATG
NgoMIV	GCCGGC	GCCGGC
NheI	GCTAGC	GCTAGC
NotI	GCGGCCGC	GCGGCCGC
NruI	TCGCGA	TCGCGA
NsiI	ATGCAT	ATGCAT
NspI	RCATGY	[AG]CATG[CT]
PacI	TTAATTAA	TTAATTAA
PciI	ACATGT	ACATGT
PmeI	GTTTAAAC	GTTTAAAC
PmlI	CACGTG	CACGTG
PsiI	TTATAA	TTATAA
PspOMI	GGGCCC	GGGCCC
PstI	CTGCAG	CTGCAG
PvuI	CGATCG	CGATCG
PvuII	CAGCTG	CAGCTG
SacI	GAGCTC	GAGCTC
SacII	CCGCGG	CCGCGG
SalI	GTCGAC	GTCGAC
SbfI	CCTGCAGG	CCTGCAGG
ScaI	AGTACT	AGTACT
SfcI	CTRYAG	CT[AG][CT]AG
SfoI	GGCGCC	GGCGCC
SgrAI	CRCCGGYG	C[AG]CCGG[CT]G
SmaI	CCCGGG	CCCGGG
SmlI	CTYRAG	CT[CT][AG]AG
SnaBI	TACGTA	TACGTA
SpeI	ACTAGT	ACTAGT
SphI	GCATGC	GCATGC
SspI	AATATT	AATATT
StuI	AGGCCT	AGGCCT
SwaI	ATTTAAAT	ATTTAAAT
XbaI	TCTAGA	TCTAGA
XhoI	CTCGAG	CTCGAG
XmaI	CCCGGG	CCCGGG
